+----------+
|L.\./.+.^.|
|..........|
|C.^.^.D. .|
|..........|
|&. .-.v.v.|
|..........|
|\.&.].~.~.|
|..........|
+----------+
