+----------+
|[.].[.C.L.|
|..........|
|\./.[.-./.|
|..........|
|L.+.D.].+.|
|..........|
|C.D.-./.[.|
|..........|
|v.v./.~.\.|
|..........|
|+.L.+.L.~.|
|..........|
+----------+
