+------------+
|~.~.~.~.+.L.|
|............|
|+.^.L.+.D.].|
|............|
|\.&.C.D.-./.|
|............|
|~.\.v.v./.~.|
|............|
+------------+
