+--------------------+
|].+.L.+.D.].+.L.\.&.|
|....................|
|C.D.].\.v./.[.].+.D.|
|....................|
|&. .C.^.^.^.D.].[.-.|
|....................|
|\.v.&.-.v.&.-./.\./.|
|....................|
|~.~.[.].+.D.].~.~.~.|
|....................|
|L.~.\./.[.-./.~.+.^.|
|....................|
+--------------------+
