+--------------------+
|v.&.].\.v./.+.^.D.-.|
|....................|
|~.[.C.L.~.~.\.&.-./.|
|....................|
|^.D.-./.+.L.~.[.C.^.|
|....................|
|-.v./.~.\./.~.\.v.&.|
|....................|
|/.+.L.+.L.~.+.L.~.\.|
|....................|
|^.D.].[.C.L.\./.+.^.|
|....................|
+--------------------+
