+--------------------+
|&.C.D.C.^.L.+.D.].\.|
|....................|
|D.-.v.&.-./.\.&.C.^.|
|....................|
|v./.~.\./.~.~.\.&.-.|
|....................|
|+.L.+.^.L.~.~.+.D.].|
|....................|
|\./.[.-./.+.^.D.-./.|
|....................|
|^.L.[.].~.\.v.&.].+.|
|....................|
+--------------------+
