00000001111111110000000000
00000001000100010000000000
00000001101100000000100000
00000001000100010000100000
00000001000000010000100000
00000001000000010000100000
00000001111111110000111110
00000000000000000000100000
00000001111111111000100000
00000001000000000000111110
00000001000000000000000000
00000001111111110000000000
