+----------+
|v.v.&.-.v.|
|..........|
|~.~.[.C.L.|
|..........|
|L.~.[. .C.|
|..........|
|C.^.D. . .|
|..........|
+----------+
