+----------+
|~.~.[.-./.|
|..........|
|~.~.\./.~.|
|..........|
|~.+.L.+.L.|
|..........|
|L.[.].[.C.|
|..........|
|C.D.C.D. .|
|..........|
|v.v.&. .-.|
|..........|
+----------+
