00000000
00111000
01111110
01111100
01111110
01111110
00000010
00000000
