000000011000000000
010001111110111000
011101111110111110
011111111111111110
001111110111100110
011111110111111110
011100111111111110
001111111010111100
111111111111111110
011111110011110000
