00000000000000
00000101000000
00111100011100
00011111101110
00111111011100
00111111111110
00101011000000
00000000000000
