+------------+
|~.+.^.L.+.L.|
|............|
|~.\.&.C.D.].|
|............|
|~.~.\.&.-./.|
|............|
|~.~.~.\./.~.|
|............|
+------------+
