+----------------------+
|/.+.+.L.~.~./.L.~.~.~.|
|......................|
|^. .-.\./.+.D.[./.+.L.|
|......................|
|].C.[./.D. .-.\.].C.[.|
|......................|
|~.^.&.D. . .\./.+.D.[.|
|......................|
|/.D.-.C.&.L./.D. .-.\.|
|......................|
|^.-.\.].v.\.^.-.C.&.L.|
|......................|
|].\.~.~.~.~.].\.].v.\.|
|......................|
+----------------------+
